SWXXXXXXXXXXXXXXXXXXXXXXXXXXXXXXXXXXXXXXXXXXXXXXXXXXXXXXXXXXXXXXXXXXXXXXXXXXXXXXXXXXXXXXXXXXXXXXXXXXXXXXXXXXXXXXXXXXXXXXXXX
WWWWXWWWXWWWXWWWWWWWWWWWXWWWWWXWXWWWXWWWWWWWXWXWXWW1WWXWWWWWXWWWXWWWWWXWWWXWWWWWXWWWWWWWWWXWXWXWWWWWXWWWWWWWWWWWWWWWWWWWWWX
XWXWXXXWXXXWXXXWXXXWXXXXXXXWXXXWXXXWXXXWXWXWXWXWXXXWXWXXXWXXXWXXXWXXXWXWXXXXXXXWXXXWXWXXXWXWXWXXXWXXXXXWXXXWXWXWXXXXXWXXXWX
XWXWXWWWWWWWWWXWXWWWWWWWXWWWWWWWWWWWWWXWXWXWWWXWWWWWXWWWWWXWWWWWXWWWXWWWWWWWWWWWXWWWXWWWXWXWWWXWXWXWWWWWWWXWXWXWWWXWWWXWXWX
XWXXXWXWXXXWXXXXXWXWXXXXXXXXXXXXXWXXXXXXXXXWXXXXXXXWXXXXXWXXXWXWXWXWXXXXXXXXXXXXXWXXXWXXXWXWXWXWXWXXXWXWXXXXXWXWXXXXXWXWXWX
XWWWXWXWXWWWWWWWWWXWWWXWWWXWXWWWWWXWWWWWWWXWWWXWWWXWXWXWWWXWWWXWXWXWXWXWWWWWXWXWWWWWXWWWXWXWXWWWWWWWXWXWWWXWWWXWWWXWWWWWXWX
XXXWXXXWXXXXXWXXXXXXXXXWXWXWXXXWXXXWXXXXXWXWXWXXXWXXXWXWXXXXXWXWXXXWXWXXXWXXXWXXXXXXXWXWXWXWXWXXXWXXXWXXXXXXXXXWXXXXXXXXXXX
XWWWXWWWXWWWWWXWWWWWWWWWXWXWWWWWXWXWXWXWWWWWXWWWWWWWXWWWWWWWXWXWWWXWWWWWXWXWXWWWWWWWXWXWXWWWXWWWXWXWXWXWWWWWXWWWWWWWWWXWWWX
XWXXXXXXXXXXXWXWXWXXXXXWXWXWXXXXXWXXXWXWXXXXXXXXXXXXXWXWXWXXXWXXXXXXXXXWXWXWXXXXXXXWXXXWXXXXXXXXXWXWXXXXXWXXXXXXXWXWXXXXXWX
XWXWWWWWWWWWXWWWXWWWXWXWXWWWWWXWXWWWWWXWWWWWWWXWWWWWXWXWXWXWWWWWXWXWXWWWWWXWWWXWWWWWWWXWWWWWXWWWXWWWWWXWWWWWWWXWXWXWXWXWXWX
XWXXXXXXXXXWXWXXXWXXXWXWXWXWXWXWXWXXXXXWXWXXXWXXXXXWXWXXXXXWXXXXXWXWXWXXXWXXXWXWXWXWXXXWXWXXXWXWXXXXXXXXXXXXXWXWXXXWXWXWXWX
XWXWWWWWWWXWXWXWXWXWXWWWXWXWXWWWWWXWWWWWXWWWXWXWWWXWWWWWWWWWXWXWWWWWXWXWWWWWWWXWXWXWXWWWXWWWXWXWXWWWWWWWXWWWXWXWXWWWXWWWXWX
XWXXXXXWXXXWXWXWXXXWXWXXXWXWXXXWXWXWXXXXXXXWXXXXXWXWXWXWXWXXXWXXXWXWXWXXXWXWXXXXXWXXXWXWXXXXXXXWXWXXXXXXXWXWXWXWXWXXXXXWXWX
XWXWXWXWWWXWWWXWXWWWXWXWWWXWXWXWXWWWWWXWWWWWWWWWWWXWXWXWXWXWWWXWWWXWWWXWWWXWXWWWXWWWXWXWXWWWXWXWXWWWWWWWXWXWWWWWXWXWWWXWWWX
XWXWXWXWXXXXXXXWXXXWXWXXXXXXXWXWXXXXXXXXXWXXXWXXXXXWXXXXXWXWXXXWXXXWXXXXXXXXXXXWXWXWXXXWXWXXXWXWXWXXXXXWXXXWXXXXXWXWXWXWXXX
XWWWXWWWWWWWWWWWXWWWWWWWWWWWXWWWXWWWWWXWXWXWWWWWXW2WXWWWWWXWXWWWXWWWWWXWWWXWWWWWWWXWXWWWWWWWXWWWWWWWXWXWXWWWXWWWXWWWXWWWWWX
XXXWXWXWXXXXXXXXXXXXXWXWXXXWXXXXXXXXXWXWXWXXXXXWXXXXXXXWXWXWXXXWXXXXXXXXXWXXXXXWXXXWXWXXXWXWXWXXXXXXXWXXXXXWXWXXXWXWXWXXXWX
XWWWXWXWWWXWWWWWWWWWXWXWXWXWWWWWXWWWWWXWWWWWWWXWWWXWWWWWXWXWWWXWWWWWWWXWWWXWWWWWXWXWWWXWWWXWXWWWWWWWWWXWXWXWWWXWWWXWXWXWXWX
XWXWXXXXXWXWXWXXXXXXXXXWXWXXXXXXXWXXXWXWXWXWXXXXXWXWXXXXXXXXXWXXXXXXXWXXXWXXXXXWXWXWXXXXXWXWXXXXXWXXXWXWXWXWXXXXXXXXXWXWXWX
XWXWXWXWXWWWXWXWWWXWWWXWXWXWWWXWWWWWXWXWXWXWXWWWXWWWXWWWXWXWWWXWWWXWXWXWWWXWWWWWXWXWXWWWXWXWXWWWXWWWXWXWWWXWXWWWWWXWXWXWXWX
XWXXXWXWXWXWXXXXXWXWXXXXXWXWXWXWXXXXXXXXXXXWXWXWXXXWXXXWXWXWXWXWXWXWXWXWXXXXXWXWXWXXXXXWXWXXXWXXXWXXXXXWXXXWXWXXXXXWXWXWXXX
XWXWXWWWWWXWXWXWXWXWWWXWWWXWXWXWXWWWWWXWWWXWXWXWXWXWWWXWWWWWXWWWXWWWXWWWWWWWWWXWWWXWXWXWWWXWWWXWWWXWWWXWWWXWXWXWWWXWWWXWWWX
XWXWXXXXXWXXXWXWXWXXXWXXXWXWXWXWXXXWXXXWXWXWXWXWXWXXXXXWXXXWXXXWXXXXXWXXXXXXXWXWXXXWXWXWXXXWXXXWXXXWXXXXXWXWXWXWXXXXXWXWXWX
XWWWXWWWWWXWWWWWXWWWXWWWWWWWXWWWXWWWXWXWXWWWWWXWWWXWWWWWXWXWXWWWXWXWWWXWWWXWXWXWWWXWWWXWXWWWWWW7WWWWXWWWWWWWWWWWWWXWXWWWXWX
XWXWXWXXXWXWXXXWXWXWXXXWXXXWXXXXXXXWXWXWXWXXXWXWXWXWXXXWXWXXXXXXXWXXXXXWXXXWXXXXXXXXXWXWXWXXXXXWXWXWXXXWXXXXXXXWXXXWXXXWXXX
XWXWWWXWXWWWWWXWXWXWXWXWWWXWXWXWWWWWWWXWXWWWXWXWXWWWXWXWWWXWWWXWWWWWWWWWXWWWWWWWWWWWXWWWWWWWXWWWXWXWXWWWXWWWXWXWWWWWXWWWWWX
XXXXXWXWXWXXXXXWXWXXXWXXXXXWXWXXXXXWXXXXXWXWXXXXXWXWXWXXXWXWXWXWXXXWXWXXXWXWXWXXXWXXXWXWXWXXXWXXXXXXXWXXXWXXXWXWXXXXXXXWXXX
XWWWWWWWXWXWXWXWWWWWWWXWXWWWWWXWXWXWXWWWWWXWXWWWWWXWWWXWWWWWXWWWXWWWXWWWXWXWXWWWXWXWWWXWXWXWWWXWWWWWXWXWXWXWWWXWWWXWXWXWWWX
XWXXXXXWXXXWXWXWXWXXXXXWXXXWXWXWXWXWXXXXXWXXXWXWXXXXXXXXXXXXXWXXXWXXXXXXXXXXXWXXXXXWXXXWXXXWXWXXXWXXXWXWXWXWXXXXXWXWXWXWXXX
XWWWWWXWWWWWWWXWXWWWWWWWXWWWXWXWWWWWXWWWWWWWXWXWWWWWWWXWXWWWXWXWWWWWWWXWWWXWWWXWWWXWXWXWXWWWXWWWXWXWXWWWXWWWWWXWWWXWWWWWXWX
XWXXXXXWXXXWXWXXXXXXXWXXXXXWXXXXXWXWXWXWXXXWXXXXXWXWXXXWXXXWXWXXXWXXXXXWXWXWXXXWXXXXXWXWXWXXXXXWXWXWXWXXXWXXXXXXXXXWXXXXXWX
XWXWXWWWWWXWXWWWXWXWXWWWXWXWWWWWXWXWWWXWWWXWXWXWXWXWXWWWXWWWWWWWXWWWWWXWXWWWWWWWXWXWWWXWXWXWWWWWWWWWWWWWWWXWWWXWXWWWXWWWWWX
XXXWXWXXXXXWXXXWXWXWXXXWXWXWXXXWXWXXXXXWXXXWXWXWXXXXXXXWXWXWXWXXXXXXXWXXXWXXXWXXXWXWXXXWXXXXXWXWXWXXXWXXXXXXXWXWXWXXXWXXXXX
XWXWXWWWWWXWWWXWXWWWWWXWWWXWXWWWXWWWXWWWWWXWWWXWXWWWWWWWXWXWXWWWWWXWXWWWXWXWWWXWXWXWXWWWXWWWXWXWXWWWXWWWWWXWXWWWXWWWWWWWWWX
XWXWXWXWXWXXXXXXXXXWXXXWXWXXXXXWXXXXXXXXXWXWXXXWXXXWXXXXXXXWXXXWXXXWXXXXXXXWXXXWXWXWXWXXXWXXXXXXXWXWXXXXXWXWXXXWXXXWXWXXXWX
XWXWWWXWXWXWWWWWXWWWWWWWXWWWWWWWXWWWXWWWWWXWXWXWWWXWWWXWWWXWWWXWWWWWXWWWWWWWXWWWXWXWWWWWWWWWXWXWXWXWXWWWXWXWWWXWWWWWXWWWXWX
XWXXXWXXXXXXXXXWXWXXXWXXXWXXXXXXXXXWXXXXXWXWXWXWXWXWXXXWXWXXXXXWXXXWXWXWXXXWXWXWXWXWXXXXXXXXXWXWXXXWXXXWXXXXXWXWXXXXXXXXXXX
XWWWWWWWWWWWXWXWWWWWXWWWXWWWXWWWWWXWXWWWXWXWWWXWXWWWWWXWXWWWXWWWXWXWXWXWXWXWXWXWWWWWWWXWWWXWWWWWWWXWWWXWWWWWXWXWWWXWXWWWWWX
XWXXXWXXXXXXXWXWXWXXXXXWXXXXXWXWXXXWXWXXXXXXXWXWXXXWXWXWXXXXXXXXXWXXXXXWXWXWXWXWXWXXXXXWXXXWXWXXXXXWXXXWXWXWXWXWXXXWXWXWXXX
XWXWWWXWWWWWXWWWXWXWWWWW3WWWWWXWXWWWXWWWXWWWXWWWWWXWXWWWWWWWXWWWXWWWXWWWXWWWXWXWXWXWXWWWXWWWXWWWXWWWXWWWXWXWWWXWXWWWXWXWWWX
XWXXXXXWXXXWXXXXXWXXXXXXXXXXXXXWXWXXXWXXXXXWXWXXXXXWXWXXXXXWXXXWXWXXXXXXXWXXXWXXXWXWXXXWXXXXXXXWXXXXXXXXXWXWXXXWXWXXXXXWXWX
XWXWWWWWXWXWWWWWXWWWWWWWWWXWWWWWWWXWXWWWWWXWWWXWWWXWXWXWWWXWWWXWXWWWWWXWWWXWWWWWXWWWWWWWWWWWXWWWXWXWWWWWXWXWWWXWWWXWWWWWXWX
XWXXXWXWXWXXXWXXXXXXXXXXXXXWXWXXXWXWXWXXXXXXXWXWXXXXXWXWXXXXXXXWXWXXXWXXXWXWXXXXXXXXXWXXXWXWXWXWXWXWXXXWXXXWXXXWXXXWXXXXXWX
XWWWXWXWXWXWWWXWWWWWXWXWWWWWXWWWXWXWWWWWWWXWXWWWWWWWXWWWXWWWWWXWWWXWXWWWWWWWWWWWWWXWWWXWWWXWWWXWWWWWXWWWXWWWXWXWWWWWXWWWWWX
XXXXXWXXXWXWXXXWXXXXXWXXXWXWXWXXXWXWXXXXXXXWXXXXXXXXXWXWXXXWXXXWXWXWXWXXXXXWXXXXXXXWXWXXXXXXXWXXXWXWXWXXXXXWXWXWXXXWXXXXXWX
XWWWXWXWXWXWWWXWWWXWWWXWWWXWXW8WXWWWXWWWXWWWXWWWWWWWXWXWXWXWWWWWXWXWXWWWXWXWWWWWWWXWXWXWWWXWWWWWXWXWXWWWWWWWWWWWWWXWXWWWWWX
XXXWXXXWXWXWXWXWXXXWXWXXXXXXXXXWXWXXXXXWXWXWXWXXXXXWXWXXXWXXXXXWXXXWXWXWXWXXXXXWXXXXXXXWXXXXXXXXXXXWXWXXXWXXXXXXXXXWXWXXXXX
XWWWXWWWWWWWXWXWXWWWXWWWWWWWWWXWXWXWXWWWXWXWWWWWXWWWWWXWWWWWWWWWXWWWWWXWWWWWXWWWWWWWXWWWWWXWXWXWXWWWXWXWXWXWXWWWWWXWXWWWXWX
XWXXXWXXXXXWXXXWXXXXXXXWXXXXXXXXXWXWXWXXXXXWXXXWXXXWXWXXXXXXXWXXXXXWXXXWXWXWXWXWXXXXXXXWXXXWXWXWXXXXXWXWXWXWXWXXXWXXXXXXXWX
XWWWWWXWXWWWXWWWWWWWWWWWXWWWXWWWWWWWWWWWXWWWXWWWXWWWXWWWWWWWWWWWXWWWXWWWXWXWXWXWWWWWXWXWXWWWWWXWXWXWWWWWXWWWXWXWWWWWWWWWWWX
XXXWXWXWXXXWXXXXXXXXXWXWXXXWXXXXXXXXXXXWXXXXXXXXXXXXXXXWXXXXXWXXXWXWXXXWXXXXXXXXXXXWXWXWXXXXXWXWXWXXXWXWXWXWXWXXXWXXXXXWXWX
XWXWXWXWXWXWWWXWXWWWWWXWWWXWWWWWWWXWWWWWWWXWWWWWWWWWXWWWXWXWWWWWXWXWXWWWWWXWWWWWWWWWWWXWWWXWWWXWWWWWWWXWXWXWXWWWXWXWXWWWXWX
XWXXXWXWXWXWXWXWXWXWXXXXXXXXXXXWXWXXXWXXXXXWXXXXXWXXXXXXXWXXXWXWXWXXXWXWXXXWXXXXXWXXXWXWXWXWXXXXXWXXXXXWXXXXXXXWXXXWXWXXXWX
XWXWXWWWXWWWXWWWWWXWWWWWWWXWXWWWXWWWWWWWWWXWXWXWXWWWWWXWWWXWXWXWXWXWWWXWWWXWWWXWWWWWXWWWXWXWWWWWXWXWWWWWWWWWXWWWW6WWXWXWWWX
XWXWXWXWXWXXXWXXXXXXXXXWXXXWXWXXXXXXXWXXXXXWXWXWXWXXXXXWXXXWXXXWXWXXXXXWXXXWXWXXXXXXXWXXXWXXXWXWXWXXXXXWXWXXXXXWXXXXXXXXXWX
XWWWXWXWXWXWXWWWXWXWWWWWWWWWWWWWXWXWXWXWWWWWWWXWWWWWWWXWXWWWWWXWXWXWXWXWWWXWXWXWWWWWXWXWWWWWXWXWXWWWXWXWXWWWXWXWWWXWXWWWWWX
XWXWXXXXXXXWXXXXXWXXXWXXXXXWXXXXXWXWXWXXXWXWXXXXXXXXXXXWXXXWXWXXXXXWXWXWXXXWXXXXXXXWXXXXXWXXXWXXXXXWXWXXXXXWXWXXXXXWXXXXXWX
XWXWXWXWWWWWWWXWXWWWWWWWWWXWXWWWWWWWWWWWWWXWWWXWWWWWWWWWWWXWXWWWXWXWWWWWXWXWWWXWWWXWXWXWXWXWWWXWXWWWXWWWXWXWWWXWWWXWXWWWWWX
XXXWXWXXXWXWXWXWXWXXXXXWXXXWXXXXXXXWXWXXXWXWXWXWXXXXXXXXXWXWXWXXXWXWXWXXXWXXXXXXXWXWXWXWXWXWXXXWXXXWXXXWXWXWXXXWXWXWXWXWXWX
XWWWWWWWWWXWXWXWXWWWXWWWWWXWXWWWWWWWXWXWWWXWXWXWWWXWWWWWXWXWXWWWXWWWXWWWWWWWXWWWXWWWXWWWXWWWWWXWWWXWWWWWXWWWXWWWXWWWXWXWXWX
XXXXXXXXXWXXXXXWXWXXXWXXXWXXXXXXXWXXXXXXXXXXXWXXXWXXXWXXXWXWXXXWXWXWXXXWXWXWXXXWXWXWXWXWXWXWXXXWXXXWXXXWXWXXXWXWXXXXXWXXXXX
XWXWWWWWXWXWWWXWWWWWXWXWXWWWXWWWXWWWXWWWWWWWXWWWXWWWWWWWXWXWXWWWWWXWWWXWXWXWWWWWXWXWWWXWXWXWWWWWXWWWWWXWXWXWXWXWWWXWWWXWWWX
XWXXXWXXXWXWXXXWXXXXXXXWXXXWXWXXXXXWXWXWXXXWXWXXXWXXXXXWXXXWXXXXXWXWXWXXXXXXXXXWXWXXXWXXXXXXXWXXXXXXXWXXXWXWXWXWXXXWXWXWXXX
XWWWWWWWWWWWWWWWWWXWWWWWXWWWXWWWWWXWXWXWWWXWWWWWWWWWXWWWWWXWXWWWXWXWXWXWWWWWWWXWWWXWWWWWXWWWXWWWXWWWXWXWXWWWWWXWWWWWXWXWXWX
XXXXXXXXXXXWXWXXXWXWXXXXXXXXXWXWXXXXXWXXXWXXXXXWXXXWXXXWXWXXXWXXXXXWXXXWXWXXXXXWXXXWXXXXXWXXXWXXXWXXXWXWXWXXXXXXXWXXXXXWXWX
XWXWWWWWWWWWXWXWWWWWXWWWXWXWXWXWXWWWXWWWXWXWWWXWWWXWXWWWXWWWWWXWWWWWXWWWXWXWWWXWXWWWWWWWWWXWXWXWWWWWWWXWXWXWXWWWWWWWWWWWXWX
XWXXXWXXXXXXXWXXXWXWXWXXXWXWXXXWXXXWXWXWXWXWXWXXXXXXXXXWXXXXXWXXXWXXXXXWXWXWXWXWXXXXXXXXXXXWXWXWXWXXXXXWXWXWXXXWXWXXXWXWXWX
XWXWXWXWWWWWXWWWXWXWXWXWWWXWWWWWWWWWWWXWXWWWXWWWXWWWWWWWXWWWXWWWXWXWWWXWXWXWXWXWXWWWXWWWWWWWXWXWXWXWWWWWXWWWWWXWXWXWXWXWWWX
XWXWXXXWXXXWXWXWXXXXXWXWXXXXXXXXXXXXXWXWXXXXXXXXXXXXXWXXXWXXXXXWXWXWXXXWXXXWXXXXXWXWXXXXXWXWXWXWXWXWXWXXXXXXXXXXXWXWXWXXXXX
XWWWWWXWXWWWWWXWXWXWXWXWWWWWWWXWWWWWWWXWWWWWWWWWXWWWWWWWWWWWXWWWWWWWWWXWWWWWXWWWXWXWXWXWWWXWXWXWXWWWXWWWXWXWXWWWXWXWXWWWXWX
XWXWXWXXXXXWXXXWXWXWXWXXXXXWXXXXXXXXXXXXXWXWXWXXXWXWXWXXXXXXXXXXXXXXXWXXXWXWXWXXXXXWXWXWXXXWXWXXXWXXXWXXXWXWXXXWXWXWXWXXXWX
XWXWXWWWWWWWXWWWWWWWXWXWWWWWWWWWWWXWWWXWWWXWXWXWXWXWXWWWXWWWXWWWXWXWXWXWWWXWXWXWWWWWXWWW5WXWWWXWWWXWWWWWXWXWWWWWWWWWXWWWWWX
XWXXXXXXXWXWXWXXXXXWXWXWXXXXXWXXXXXWXWXXXXXXXWXWXXXXXWXWXWXWXWXXXWXWXWXWXXXWXWXXXXXWXXXXXXXXXWXWXXXXXXXWXWXXXXXWXXXWXXXWXXX
XWXWWWWWWWXWXWXWWWWWXWWWXWWWWWXWWWXWXWWWXWWWXWXWXWWWWWXWWWXWXWWWXWWWWWWWXWWWWWXWXWWWWWWWXWWWXWXWXWWWXWWWXWWWXWWWWWXWXWWWXWX
XXXXXWXXXXXWXXXXXWXXXWXXXXXWXXXXXWXXXWXWXWXWXWXWXXXXXXXXXXXXXWXXXXXXXXXXXXXXXWXWXWXXXWXWXWXWXXXWXWXXXXXWXWXXXXXWXWXXXXXXXWX
XWW4WWXWXWXWXWWWXWWWWWXWWWXWWWWWXWWWWWXWXWXWXWXWXWXWXWWWWWXWWWWWWWWWXWWWWWXWXWWWWWXWXWXWWWXWXWWWXWWWWWWWWWWWWWXWXWXWWWWWXWX
XWXWXWXWXWXXXXXWXWXXXWXXXWXXXWXWXWXXXXXWXWXXXXXWXWXWXWXXXXXWXXXXXWXXXWXWXXXWXWXXXXXWXWXXXXXXXXXWXWXWXXXWXXXWXWXXXXXWXXXWXWX
XWXWXWWWWWWWXWWWXWXWXWXWXWWWXWXWWWXWWWWWXWXWWWWWWWXWWWW9WWWWWWWWXWWWWWXWWWXWXWXWWWWWWWXWXWXWXWWWXWXWXWWWWWXWXWWWWWWWXWWWXWX
XWXXXXXWXWXXXXXWXXXWXWXWXXXWXWXWXXXXXWXWXWXWXXXXXWXWXXXWXWXWXXXWXWXWXXXWXXXWXXXWXXXWXWXWXWXWXWXXXXXXXWXWXXXXXWXWXWXXXWXWXWX
XWWWWWXWXWWWWWWWWWXWWWXWWWWWWWXWWWWWXWXWWWWWWWWWXWWWXWWWXWXWXWWWXWXWWWXWWWWWWWXWXWWWXWXWWWWWWWWWWWXWWWXWWWWWXWXWXWWWXWXWWWW
XXXXXXXXXXXXXXXXXXXXXXXXXXXXXXXXXXXXXXXXXXXXXXXXXXXXXXXXXXXXXXXXXXXXXXXXXXXXXXXXXXXXXXXXXXXXXXXXXXXXXXXXXXXXXXXXXXXXXXXXXWZ
