S..WWWWWWWWWWWWW
...W..3........W
W..W..WWWWWWW..W
W1....W...5....W
W.WWWWW..WWWWWWW
W.WW4....6....7W
WWWW..W..W..W..W
W..W..W..W..W..W
W2.WWWWWWW..WWWW
W.....8.........
WWWWWWWWWWWWWW.Z
