..WWWWWWWWWWWWWWWWWWW
..W...W..1W.W.W.W...W
W.W.WWWWW.W.W.W.W.WWW
W...W3W.......W...W2W
WWW.W.W.W.WWW.W.W.W.W
W...W.W.WSW.9...W...W
W.WWW.WWWWWWW.W.WWWWW
W.4.W...W...W.W.W...W
W.WWW.WWWWW.WWW.W.W.W
W...W...W.8.W.W...W.W
W.WWW.WWW.WWW.W.WWW.W
W.......W.........W.W
W.WWWWWWWWWWW.W.WWWWW
W...W......6W.W.....W
W.WWW.WWW.WWWWW.W.W.W
W.....W...W.7...W.W.W
W.WWW.WWW.W.W.WWWWWWW
W...W.W...W.W.......W
W.W.WWW.WWWWWWWWW.W.W
WZW.5.W...........W..
WWWWWWWWWWWWWWWWWWW..
